border_size=1
usage=map

Gs^Fp       , Gs^Fp       , Gs^Fp       , Gs^Fp       , Gs^Fp       , Gs^Fp       , Gs^Fp       , Gs^Fp       , Gs^Fp       , Gs^Fp       , Gs^Fp       , Gs^Fp       , Gs^Fp       , Gs^Fp       , Gs^Fp       , Gs^Fp       , Gs^Fp       , Gs^Fp       , Gs^Fp       
Gs^Fp       , Gs^Fp       , Gs^Fp       , Gs^Fp       , Gs^Fp       , Gs^Fp       , Gs^Fp       , Gs^Fp       , Gs^Fp       , Gs^Fp       , Gs^Fp       , Gs^Fp       , Gs^Fp       , Gs^Fp       , Gs^Fp       , Gs^Fp       , Gs^Vht      , Gs^Fp       , Gs^Fp       
Gs^Fp       , Gs^Fp       , Hh          , Hh^Fp       , Gs^Fp       , Gs^Fp       , Gs^Fp       , Gs^Fp       , Ce          , Ke          , Ce          , Gs^Fp       , Gs^Fp       , Gs^Fp       , Gs^Fp       , Gs^Fp       , Gs^Fp       , Gs^Fp       , Gs^Fp       
Gs^Fp       , Gs^Fp       , Gs^Fp       , Gs^Fp       , Gs^Fp       , Gs^Fp       , Ce          , Ce          , Gg          , Gg^Ve       , Gg^Wm       , Ce          , Ce          , Gs^Fp       , Gs^Fp       , Gs^Fp       , Gs^Fp       , Gs^Fp       , Gs^Fp       
Gs^Fp       , Gs^Fp       , Gs^Fp       , Gs^Fp       , Ce          , Ce          , Re^Gvs      , Re^Gvs      , Ggf         , Gg          , Ggf         , Re^Gvs      , Re^Gvs      , Ce          , Ce          , Gs^Fp       , Gs^Fp       , Gs^Fp       , Gs^Fp       
Gs^Fp       , Gs^Fp       , Gs^Fp       , Ke          , Gg^Ve       , Gg^Wm       , Ggf         , Ggf         , Ch          , Ch          , Ch          , Ggf         , Ggf         , Gg          , Gg^Ve       , Ke          , Gs^Fp       , Gs^Fp       , Gs^Fds      
Re          , Gs^Fp       , Gs^Fp       , Ce          , Gg          , Gg          , Ch          , Ch          , Cv          , Kv          , Cv          , Ch          , Ch          , Gg          , Gg^Wm       , Ce          , Gs^Fp       , Gs^Fp       , Gs^Fp       
Gs^Fp       , Re          , Re          , Ce          , Re^Gvs      , Ggf         , Ch          , Kv          , Cv          , Cv          , Cv          , Kv          , Ch          , Ggf         , Re^Gvs      , 3 Ce        , Gs^Fp       , Gs^Fp       , Gs^Fp       
Gs^Fp       , Gs^Fp       , Gs^Fp       , Ce          , Re^Gvs      , Ggf         , Ch          , Cv          , Cv          , 4 Kv        , Cv          , Cv          , Ch          , Ggf         , Re^Gvs      , 2 Ce        , Gs^Fp       , Gs^Fp       , Gs^Fp       
Gs^Fp       , Gs^Fp       , Gs^Fp       , Ce          , Gg^Wm       , Ggf         , Ch          , Kv          , Cv          , Cv          , Cv          , Kv          , Ch          , Ggf         , Gg          , 1 Ce        , Gs^Fp       , Gs^Fp       , Gs^Fp       
Gs^Fp       , Gs^Fp       , Gs^Fp       , Ce          , Gg^Ve       , Gg          , Ggf         , Ch          , Ch          , Kv          , Ch          , Ch          , Ggf         , Gg          , Gg^Ve       , Ce          , Gs^Fp       , Gs^Fp       , Gs^Fp       
Gs^Fp       , Gs^Fp       , Gs^Fp       , Ke          , Ce          , Gg          , Re^Gvs      , Ggf         , Ggf         , Ch          , Ggf         , Ggf         , Re^Gvs      , Gg^Wm       , Ce          , Ke          , Gs^Fp       , Gs^Fp       , Gs^Fp       
Gs^Fp       , Gs^Fp       , Gs^Fp       , Gs^Fp       , Gs^Fp       , Ce          , Ce          , Re^Gvs      , Gg^Wm       , Gg          , Gg          , Re^Gvs      , Ce          , Ce          , Gs^Fp       , Gs^Fp       , Gs^Fp       , Gs^Fp       , Re          
Gs^Fp       , Gs^Fp       , Gs^Fp       , Gs^Fp       , Gs^Fp       , Gs^Fp       , Gs^Fp       , Ce          , Ce          , Gg^Ve       , Ce          , Ce          , Gs^Fp       , Gs^Fp       , Gs^Fp       , Gs^Fp       , Re          , Re          , Gg          
Gs^Fp       , Gs^Fp       , Gs          , Gs          , Gs^Fp       , Gs^Fp       , Gs^Fp       , Gs^Fp       , Gs^Fp       , Ke          , Gs^Fp       , Re          , Re          , Gs^Fp       , Re          , Re          , Ggf         , Gg          , Gg          
Gs^Fp       , Gs          , Gs          , Gs          , Gs          , Gs^Fms      , Gs^Fms      , Gs^Fp       , Gs^Fp       , Gs^Fp       , Gs^Fp       , Re          , Gs^Fp       , Re          , Gs^Fp       , Gs^Fp       , Gs^Fp       , Gg^Ve       , Gs^Fp       
Gs^Fp       , Gs^Fp       , Gs^Fp       , Gs          , Gs^Fms      , Gs^Fms      , Gs^Fp       , Gs^Fms      , Gs^Fms      , Gs^Fp       , Re          , Re          , Gs^Fp       , Gs^Fp       , Gs^Fp       , Gs^Fp       , Gs^Fp       , Gs^Fp       , Gs^Fp       
