border_size=1
usage=map

Aa^Fpa      , Aa^Fpa      , Aa^Fpa      , Aa^Fpa      , Aa^Fpa      , Aa^Fpa      , Aa^Fpa      , Aa^Fpa      , Aa^Fpa      , Aa^Fpa      , Aa^Fpa      , Aa^Fpa      , Aa^Fpa      , Aa^Fpa      , Aa^Fpa      , Aa^Fpa      , Aa^Fpa      , Aa^Fpa      , Aa^Fpa      , Aa^Fpa      , Aa^Fpa      , Aa^Fpa      , Aa^Fpa      , Aa^Fpa      , Aa^Fpa      , Aa^Fpa      , Aa^Fpa      , Aa^Fpa      , Aa^Fpa      , Aa^Fpa      , Aa^Fpa      , Aa^Fpa      , Aa^Fpa      , Aa^Fpa      , Aa^Fpa      , Aa^Fpa      , Aa^Fpa      
Ha          , Aa^Fpa      , Aa^Fpa      , Aa^Fpa      , Aa^Fpa      , Aa^Fpa      , Ha^Fpa      , Ha^Fpa      , Ha          , Aa^Fpa      , Ha^Vhha     , Aa^Fpa      , Ha^Fpa      , Ha^Fpa      , Ha          , Ha          , Ha          , Ha          , Ha          , Aa^Fpa      , Aa^Fpa      , Aa^Fpa      , Aa^Fpa      , Aa^Fpa      , Aa^Fpa      , Aa^Fpa      , Aa^Fpa      , Aa^Fpa      , Aa^Fpa      , Aa^Fpa      , Aa^Fpa      , Aa^Fpa      , Aa^Fpa      , Aa^Fpa      , Aa^Fpa      , Aa^Fpa      , Aa^Fpa      
Mm          , Aa^Vha      , Ha          , Ha          , Ha          , Aa^Fpa      , Aa^Fpa      , Ha          , Ms          , Mm          , Ha          , Ha          , Ha^Fpa      , Ha          , Ch          , Ch          , Ch          , Ha          , Ha          , Aa^Vha      , Aa^Fpa      , Aa^Fpa      , Aa^Fpa      , Aa^Fpa      , Aa^Fpa      , Aa^Fpa      , Ha          , Ha^Fpa      , Aa^Fpa      , Aa^Fpa      , Aa^Vea      , Ha          , Ha          , Ha          , Ha          , Ha          , Ha          
Mm          , Mm          , Mm          , Mm          , Ha^Fpa      , Aa^Fpa      , Ms          , Ms          , Ms          , Mm          , Mm          , Ha^Fpa      , Ha          , Ha          , Ch          , 5 Kh        , Ch          , Ch          , Ha          , Ha          , Aa^Fpa      , Aa^Fpa      , Aa^Fpa      , Aa^Fpa      , Ha          , Aa^Fpa      , Ha          , Aa^Fpa      , Aa^Fpa      , Aa^Fpa      , Ha^Fpa      , Mm          , Ms          , Mm          , Mm          , Mm          , Mm          
Ha          , Ha          , Ha          , Ha          , Ha^Fpa      , Aa^Fpa      , Ha          , Ha          , Mm          , Mm          , Mm          , Ms          , Ms          , Ha          , Ha          , Ch          , Ha          , Ha          , Mm          , Ha          , Ha          , Ha^Fpa      , Ha^Fpa      , Ha          , Ms          , Ha^Vhha     , Mm          , Ha          , Mm          , Aa^Fpa      , Ms          , Ms          , Ha          , Ha          , Ms          , Ms          , Mm          
Mm          , Mm          , Mm          , Mm          , Ha^Fpa      , Ha^Fpa      , Mm          , Mm          , Mm          , Mm          , Mm          , Ms          , Mm          , Mm          , Ha          , Ha          , Mm          , Mm          , Mm          , Ms          , Ms          , Ha          , Ha^Fpa      , Ms          , Ms          , Mm          , Ha          , Mm          , Ha          , Mm          , Ha          , Ha^Vhha     , Mm          , Ha          , Mm          , Ms          , Mm          
Mm          , Ha          , Mm          , Mm          , Ha          , Ha          , Mm          , Mm          , Mm^Vhh      , Mm          , Mm          , Mm          , Mm          , Mm          , Ha          , Mm          , Mm          , Mm          , Mm          , Mm^Vhh      , Mm          , Ms          , Mm          , Ha^Fpa      , Ha          , Ha          , Mm          , Ha          , Mm          , Mm          , Mm          , Mm          , Ch          , Mm          , Mm          , Ms          , Mm          
Mm          , Aa^Vha      , Ha          , Ha          , Ha          , Mm          , Mm          , Ms          , Ms          , Mm          , Mm          , Mm          , Mm          , Mm          , Ha          , Mm          , Mm^Xm       , Mm          , Ms          , Mm          , Mm          , Mm          , Mm          , Ha^Fpa      , Mm          , Mm          , Ha          , Mm          , Ha          , Ha          , Ch          , Ch          , 6 Kh        , Ch          , Mm          , Ms          , Mm          
Mm          , Ha          , Mm          , Ha          , Mm          , Ha          , Ha          , Ha          , Mm          , Ms          , Mm          , Mm          , Mm          , Mm          , Ha          , Mm^Xm       , Mm^Xm       , Mm^Xm       , Mm          , Ms          , Mm          , Mm          , Ha^Fpa      , Ha^Fpa      , Hh          , Ha          , Mm          , Ha          , Mm          , Mm          , Mm          , Ch          , Ch          , Ch          , Mm          , Mm          , Mm          
Mm          , Mm          , Mm          , Ms          , Mm          , Ha          , Ha          , Ha          , Mm          , Mm          , Mm          , Mm          , Mm          , Mm          , Mm          , Ha          , Mm          , Mm          , Mm          , Mm          , Mm^Vhh      , Mm          , Ha^Fpa      , Ha^Fpa      , Ha^Vhha     , Mm          , Mm          , Mm          , Ha          , Ha^Vhha     , Ha          , Mm          , Mm          , Mm          , Mm          , Mm          , Mm          
Mm          , Mm          , Ha          , Ha          , Mm          , Mm          , Mm          , Mm          , Mm          , Mm          , Ha          , Mm          , Ha          , Mm          , Mm          , Ha          , Mm          , Mm^Vhh      , Mm          , Mm          , Mm          , Mm          , Hh          , Mm          , Ha          , Ha          , Mm          , Ha          , Ha          , Ha          , Ha          , Mm          , Hh^Fdf      , Mm          , Ha          , Ha^Vhha     , Mm          
Mm          , Mm          , Mm^Vhh      , Mm          , Mm          , Mm          , Mm          , Mm          , Mm          , Mm          , Mm          , Mm          , Mm          , Mm          , Mm          , Mm          , Ha          , Mm          , Mm          , Mm          , Hh          , Hh^Fdw      , Mm          , Mm          , Mm          , Mm          , Mm          , Mm          , Mm          , Mm          , Mm          , Mm          , Hh          , Hh^Fdf      , Mm          , Mm          , Mm          
Mm          , Mm          , Mm          , Mm          , Mm          , Mm          , Mm          , Mm          , Mm          , Mm          , Mm          , Hh^Vhh      , Mm          , Mm          , Mm^Xm       , Mm          , Mm          , Ha          , Ha          , Mm          , Hh^Fdw      , Mm          , Mm          , Mm^Vhh      , Mm          , Ha          , Mm          , Ha          , Mm          , Hh^Fdf      , Hh^Fdf      , Mm          , Re          , Mm          , Mm          , Mm          , Mm          
Hh^Fdf      , Hh          , Hh          , Hh          , Hh^Fdw      , Hh          , Hh          , Hh          , Hh          , Hh          , Mm          , Mm          , Mm          , Mm^Xm       , Mm^Xm       , Mm^Xm       , Mm          , Mm          , Mm          , Mm          , Hh          , Mm          , Mm          , Mm          , Mm          , Mm          , Mm          , Mm          , Hh^Vhh      , Hh          , Hh^Fdf      , Hh^Fdf      , Re          , Hh^Vhh      , Hh^Fmf      , Hh^Fdf      , Hh^Fdf      
Hh^Fdf      , Hh^Fdf      , Mm          , Mm          , Mm          , Hh^Fdw      , Mm          , Hh          , Mm          , Mm          , Mm          , Mm          , Mm          , Mm^Xm       , Mm          , Mm^Xm       , Mm          , Mm          , Mm          , Mm          , Hh^Fdf      , Mm          , Xu          , Mm          , Xu          , Mm          , Mm          , Mm          , Mm          , Hh          , Hh^Fdf      , Hh^Fdf      , Re          , Hh          , Hh^Fmf      , Hh^Fdf      , Hh          
Hh^Fdf      , Hh^Fdf      , Hh          , Mm          , Mm          , Mm          , Mm          , Mm          , Mm          , Mm          , Mm          , Mm          , Mm^Vhh      , Mm          , Mm          , Mm          , Mm          , Mm          , Mm          , Mm          , Re          , Xu          , Uu          , Xu          , Uu^Vud      , Xu          , Xu          , Mm          , Mm          , Mm          , Hh^Fdf      , Hh^Fdf      , Re          , Hh^Fdf      , Hh          , Hh^Fmf      , Hh          
Hh          , Hh          , Mm          , Mm^Vhh      , Mm          , Mm          , Mm          , Mm          , Ch          , Ch          , 3 Kh        , Mm          , Re          , Re          , Re          , Hh          , Mm          , Mm          , Ch          , Re          , Mm          , Re          , Xu          , Uu          , Uu          , Uh          , Xu          , Xu          , Xu          , Hh          , Hh^Fdf      , Hh          , Re          , Hh^Fdf      , Gg          , Hh^Fmf      , Gg          
Mm          , Hh          , Hh          , Mm          , Mm          , Mm          , Ch          , Ch          , Ch          , 1 Kh        , 2 Kh        , Ch          , Mm          , Mm          , Mm          , Re          , Re          , Ch          , 4 Kh        , Ch          , Mm          , Mm          , Gg^Vh       , Xu          , Uu^Vu       , Uu          , Uu          , Re          , Re          , Hh          , Re          , Re          , Gg^Vh       , Gg          , Gs^Fp       , Gg          , Gs^Fp       
Mm          , Hh          , Mm          , Mm          , Re          , Re          , Mm          , Ch          , Mm          , Ch          , Mm          , Mm          , Mm          , Mm          , Mm          , Hh          , Mm          , Ch          , Ch          , Ch          , Mm          , Gs^Fdf      , Xu          , Xu          , Xu          , Xu          , Xu          , Xu          , Xu          , Re          , Re          , Gg          , Gs^Fp       , Gs^Fdf      , Gs^Fmf      , Gg          , Gs^Fp       
Mm          , Mm          , Re          , Re          , Mm^Vhh      , Hh          , Mm          , Mm          , Mm          , Mm          , Mm          , Mm          , Mm          , Mm          , Mm          , Hh          , Mm          , Mm          , Mm          , Mm^Vhh      , Mm          , Gs^Fp       , Gs^Fdf      , Xu          , Gs^Fp       , Gs^Fdf      , Xu          , Gs^Fdf      , Gs^Fp       , Xu          , Gs^Fp       , Re          , Re          , Gs^Fdf      , Gs^Fmf      , Gs^Fdf      , Gs^Fdf      
Re          , Mm          , Mm          , Mm          , Mm          , Mm          , Hh          , Mm          , Mm          , Mm          , Hh          , Mm          , Mm^Vhh      , Mm          , Mm          , Hh          , Mm          , Mm          , Mm          , Mm          , Gs^Fdf      , Gs^Fdf      , Gg^Vh       , Gs^Fdf      , Gs^Fmf      , Gs^Fdf      , Gs^Fmf      , Gs^Fdf      , Gs^Fmf      , Gs^Fdf      , Gs^Fmf      , Gg^Ve       , Gs^Fdf      , Re          , Re          , Gs^Fp       , Gs^Fp       
Re          , Re          , Mm          , Hh          , Mm          , Hh          , Gs^Fp       , Mm          , Mm          , Hh          , Mm          , Hh          , Hh          , Mm          , Hh          , Hh          , Mm          , Mm          , Mm          , Mm          , Gs^Fp       , Gs^Fmf      , Gs^Fp       , Gs^Fp       , Gs^Fp       , Gs^Fmf      , Gs^Fp       , Gs^Fmf      , Gs^Fp       , Gs^Fmf      , Gs^Fp       , Gs^Fmf      , Gs^Fp       , Gs^Fp       , Gs^Fp       , Re          , Re          
