border_size=1
usage=map

Hh          , Hh          , Hh          , Ww          , Ww          , Ww          , Ww          , Ww          , Ww          , Ww          , Ww          , Hh          , Hh          , Hh          , Hh          , Hh          , Ggf         , Hh          , Hh          , Hh          , Hh          , Hh          , Re          , Re          , Kh          , Hh          , Hh          , Hh          , Gg          , Gg          , Gg          , Gs^Fp       , Gg          , Gg          , Gg          , Gg          
Hh          , Hh          , Gg          , Hh          , Ww          , Ww          , Ww          , Ww          , Chs         , Chs         , Chs         , Gg          , Gg          , Hh          , Gg          , Hh          , Hh          , Hh          , Hh          , Hh          , Hh          , Ch          , 3 Kh        , 2 Kh        , 1 Kh        , Ch          , Ch          , Hh          , Hh^Fds      , Gg          , Gg          , Gg          , Gg          , Gg          , Gg          , Gg          
Hh          , Hh          , Gg          , Hh          , Gg          , Ww          , Gg          , Ww          , Ss^Vhs      , 9 Khs       , Gg          , Hh          , Hh          , Gg          , Hh          , Gg^Ve       , Hh          , Hh          , Hh          , Hh          , Hh          , Re          , Gg^Ve       , Ch          , Ch          , Ch          , Ch          , Hh          , Gg          , Hh^Fds      , Gg          , Hh^Fds      , Gg          , Gg          , Hh          , Gg          
Hh          , Hh          , Hh          , Gg          , Gg          , Gg          , Hh          , Gg          , Gg          , Hh          , Gg          , Hh          , Hh          , Ggf         , Hh          , Hh          , Hh          , Hh          , Hh          , Hh          , Re          , Re          , Hh          , Hh          , Ch          , Ch          , Hh          , Hh          , Hh          , Hh^Fds      , Gg          , Gg          , Gg          , Hh^Fds      , Hh          , Gg          
Hh          , Hh          , Gg          , Hh          , Gg          , Hh          , Gg          , Hh          , Hh          , Hh          , Hh          , Hh          , Hh          , Hh          , Hh          , Hh          , Hh          , Hh          , Hh          , Re          , Re          , Hh          , Hh          , Hh          , Hh          , Hh          , Hh          , Hh          , Hh          , Hh          , Hh          , Gg          , Gg          , Gg          , Hh          , Gg          
Hh          , Gg          , Hh          , Gg          , Gg          , Gg          , Hh          , Hh          , Ggf         , Hh          , Hh          , Gg          , Hh          , Hh          , Hh          , Hh          , Hh          , Hh          , Re          , Re          , Hh          , Hh          , Hh          , Hh          , Hh^Fds      , Hh          , Hh^Fds      , Hh          , Gg          , Gg          , Hh          , Hh          , Hh          , Hh          , Hh          , Gg          
Gg          , Hh          , Hh          , Hh          , Gg          , Hh          , Hh          , Hh          , Hh          , Hh          , Hh          , Gg          , Hh          , Hh          , Hh          , Hh          , Re          , Re          , Hh          , Hh          , Hh          , Hh          , Hh          , Hh          , Hh          , Hh^Fds      , Gg          , Hh^Fds      , Gg          , Hh          , Gg          , Hh          , Gg          , Gg          , Hh          , Gg          
Hh          , Hh          , Hh          , Gs^Vht      , Hh          , Hh          , Hh          , Hh          , Hh          , Hh          , Hh          , Hh          , Hh          , Hh          , Hh          , Hh^Vhh      , Re          , Re          , Hh          , Hh          , Hh          , Gg          , Gg          , Gg          , Gg          , Hh          , Hh          , Hh          , Hh          , Hh          , Gg          , Gg          , Gg          , Hh          , Gg          , Gg          
Hh          , Hh          , Hh          , Hh          , Hh          , Hh          , Hh          , Hh          , Hh          , Gg          , Hh          , Hh          , Hh          , Hh          , Re          , Re          , Hh          , Hh          , Hh          , Hh          , Gg          , Gg          , Gs^Vht      , Gg          , Hh          , Hh          , Hh          , Hh          , Hh          , Hh          , Hh          , Gg          , Hh          , Hh          , Hh          , Gg          
Hh          , Hh          , Hh          , Hh          , Hh          , Hh          , Hh          , Hh          , Hh          , Hh          , Hh          , Hh          , Hh          , Hh          , Re          , Hh          , Hh          , Hh          , Gg          , Gg          , Hh          , Gg          , Gg          , Gg          , Hh          , Gg          , Gg          , Hh          , Hh          , Hh          , Hh          , Hh          , Gg          , Hh          , Hh          , Gg          
Hh          , Hh          , Hh          , Hh          , Hh^Vhh      , Hh          , Hh          , Hh          , Hh          , Hh          , Hh          , Hh          , Hh          , Hh          , Re          , Hh          , Hh          , Gg          , Hh          , Hh          , Gg          , Hh          , Gg          , Gg          , Gg          , Hh          , Hh          , Hh          , Hh          , Hh          , Hh          , Hh          , Hh          , Hh          , Hh          , Hh          
Hh          , Hh          , Hh          , Hh          , Hh          , Hh          , Hh          , Hh          , Hh          , Hh          , Hh          , Hh          , Hh          , Hh          , Re          , Hh          , Hh          , Hh          , Hh          , Hh          , Hh          , Gg          , Hh          , Hh          , Hh          , Hh          , Hh          , Hh          , Hh          , Hh          , Hh          , Hh          , Hh          , Hh          , Hh          , Hh          
Hh          , Hh          , Hh          , Hh          , Hh          , Hh          , Hh          , Hh          , Hh          , Hh          , Hh          , Hh          , Hh          , Re          , Hh          , Re          , Re          , Hh          , Hh          , Hh          , Hh          , Hh          , Hh          , Hh          , Hh          , Hh          , Hh          , Hh          , Hh          , Hh          , Hh          , Hh          , Hh          , Hh          , Hh          , Hh          
Hh          , Hh          , Hh          , Hh          , Hh          , Hh          , Hh          , Hh          , Hh          , Hh          , Hh          , Hh          , Hh^Vhh      , Re          , Hh          , Hh          , Hh          , Re          , Re          , Hh          , Hh^Vhh      , Hh          , Hh          , Hh          , Hh          , Hh          , Hh          , Hh          , Hh          , Hh          , Hh          , Hh          , Hh          , Hh          , Hh          , Hh          
Hh          , Hh          , Hh          , Hh          , Hh          , Hh          , Hh          , Hh          , Hh          , Hh          , Hh          , Hh          , Hh          , Re          , Hh          , Hh          , Hh          , Hh          , Hh          , Re          , Re          , Hh          , Hh          , Hh          , Hh          , Hh          , Hh          , Hh          , Hh          , Hh          , Hh          , Hh          , Hh          , Hh          , Hh          , Hh          
Hh          , Hh          , Hh          , Hh          , Hh          , Hh          , Hh          , Hh          , Hh          , Hh          , Hh          , Hh          , Hh          , Re          , Hh          , Hh          , Mm          , Mm          , Mm          , Hh          , Hh          , Re          , Re          , Hh          , Hh          , Hh          , Hh          , Hh          , Mm          , Hh          , Mm          , Mm          , Re          , Mm          , Mm          , Hh          
Hh          , Hh          , Hh          , Hh          , Hh          , Hh          , Hh          , Hh          , Hh          , Hh          , Hh          , Hh          , Hh          , Re          , Hh          , Mm          , Mm^Xm       , Mm          , Mm^Xm       , Mm          , Hh          , Hh          , Hh          , Re          , Re          , Re          , Re          , Mm          , Re          , Mm          , Re          , Re          , Mm          , Re          , Re          , Re          
Hh          , Hh          , Hh          , Hh^Vhh      , Hh          , Hh          , Hh          , Hh          , Hh          , Hh          , Hh          , Hh          , Hh          , Re          , Hh          , Mm          , Mm^Xm       , Mm^Xm       , Mm^Xm       , Mm          , Hh          , Hh          , Hh          , Hh          , Mm          , Mm          , Mm          , Re          , Mm          , Re          , Mm          , Mm          , Mm          , Mm          , Mm          , Hh          
Hh          , Hh          , Hh          , Hh          , Hh          , Hh          , Hh          , Hh          , Hh          , Hh          , Hh          , Hh          , Hh          , Re          , Hh          , Mm          , Mm^Vhh      , Mm^Xm       , Mm          , Mm          , Hh          , Hh          , Mm^Vhh      , Mm          , Uu^Ii       , Mm          , Uu^Ii       , Mm          , Xu          , Mm          , Xu          , Mm          , Mm          , Mm          , Mm          , Hh          
Hh          , Hh          , Hh          , Hh          , Hh          , Hh          , Hh          , Hh          , Hh          , Hh^Vhh      , Hh          , Hh          , Hh          , Re          , Hh          , Hh          , Hh          , Mm          , Mm          , Mm          , Mm          , Mm          , Xu          , Xu          , Uu^Ii       , Uu^Ii       , Uu^Vud      , Xu          , Uu          , Xu          , Uu          , Xu          , Xu          , Xu          , Xu          , Xu          
Hh          , Hh          , Hh          , Hh          , Hh          , Hh          , Hh          , Hh          , Hh          , Hh          , Hh          , Hh          , Hh          , Re          , Hh          , Hh          , Hh          , Hh          , Mm          , Mm          , Xu          , Xu          , Uu          , Uu          , Uu          , Uu          , Uu          , Uu          , Uu          , Uu          , Uu          , Uu          , Uu          , Uu^Vu       , Uu          , Xu          
Hh          , Hh          , Hh          , Hh          , Hh          , Hh          , Hh          , Hh          , Hh          , Hh          , Hh          , Hh          , Hh          , Re          , Hh          , Hh          , Hh          , Hh          , Mm          , Xu          , Uh          , Uu          , Uu          , Uu          , Uu^Uf       , Uu          , Uu          , Uu          , Uu          , Uu          , Uu          , Uu          , Uu          , Uu          , Uu          , Uu          
Hh          , Hh          , Hh          , Hh^Vhh      , Hh          , Hh          , Hh          , Hh          , Hh          , Hh          , Hh          , Hh          , Hh          , Re          , Hh          , Hh          , Hh          , Mm          , Xu          , Xu          , Uh          , Uh          , Uu          , Xu          , Xu          , Uu          , Uu^Uf       , Uu          , Uu          , Uu          , Uu          , Uu          , Uu          , Uu          , Uu          , Uu          
Hh          , Hh          , Hh          , Hh          , Hh          , Hh          , Hh          , Hh          , Hh          , Hh          , Hh          , Hh          , Ch          , Re          , Ha          , Hh          , Ha          , Ha^Vhha     , Xu          , Uu^Vud      , Xu          , Uh          , Uu          , Xu          , Uu          , Xu          , Xu          , Xu          , Xu          , Uu^Vu       , Xu          , Uu          , Xu          , Uu          , Uu          , Uu          
Hh          , Hh          , Hh          , Hh          , Hh          , Hh          , Hh          , Hh          , Hh          , Hh          , Ch          , Ch          , 5 Kh        , Ch          , Ch          , Ha          , Xu          , Xu          , Xu          , Xu          , Xu          , Uu          , Uu          , Uu          , Uu          , Uu          , Uu          , Uu          , Uu          , Xu          , Uu          , Xu          , Uu          , Uu          , Uu          , Uu          
Hh          , Hh          , Hh          , Hh          , Hh          , Hh          , Hh          , Mm^Vhh      , Ch          , Ch          , Ch          , Ch          , Hh          , 4 Kh        , Ch          , Ch          , Cud         , Cud         , Cud         , Cud         , Cud         , Xu          , Xu          , Uu^Vu       , Uu          , Uu          , Uu          , Uu          , Uu          , Uu          , Uu          , Uu          , Uu          , Uu          , Uu^Vu       , Uu          
Hh          , Hh          , Hh          , Hh          , Hh          , Hh          , Chr         , Ch          , Hh          , Ch          , Hh          , Hh          , Hh          , Re          , Ha^Vhha     , Ha          , Xu          , Xu          , Xu          , Xu          , Xu          , Cud         , Cud         , Uu          , Uu^Uf       , Uu          , Uu^Vud      , Uu          , Uu          , Cud         , Cud         , Uu          , Uu          , Uu          , Uu          , Uu          
Hh          , Hh^Vhh      , Hh          , Hh          , Hh          , Hh          , Chr         , Hh          , Hh          , Hh          , Hh          , Hh          , Hh          , Re          , Ha          , Ha          , Xu          , Xu          , Xu          , Xu          , Xu          , Xu          , Xu          , Cud         , Cud         , Uu          , Uu          , Uu          , Cud         , Cud         , 6 Kud       , Cud         , Uu          , Uu          , Uu          , Uu          
Hh          , Hh          , Hh          , Hh          , Chr         , Chr         , Hh          , Hh          , Hh          , Hh          , Hh          , Hh          , Ms          , Hh          , Ms          , Ms          , Xu          , Xu          , Xu          , Xu          , Uu          , Xu          , Xu          , Uu          , Uu          , Cud         , Cud         , Cud         , Cud         , Cud         , Cud         , Cud         , Uu          , Uu          , Uu          , Uu          
Ms          , Hh          , Chr         , Chr         , 8 Khr       , Chr         , Hh          , Hh          , Hh          , Hh          , Hh          , Ms          , Ms          , Ms          , Ms          , Uu          , Uu          , Xu          , Uu          , Uu          , Uu          , Uu^Vu       , Uu          , Xu          , Xu          , Uu          , Uu          , Cud         , 7 Kud       , Cud         , Cud         , Uu          , Uu          , Uu          , Uu          , Uu          
Ms          , Ms          , Ms          , Chr         , Chr         , Chr         , Ms          , Ms          , Ms          , Ms          , Ms          , Ms          , Ms          , Ms          , Uu          , Uu          , Uu          , Uu          , Uu          , Uu          , Uu          , Uu          , Uu          , Uu          , Uu          , Uu          , Uu          , Cud         , Cud         , Cud         , Uu          , Uu          , Uu          , Uu          , Uu          , Uu          
Ms          , Ms          , Ms          , Ms          , Ms          , Ms          , Ms          , Ms          , Ms          , Ms          , Ms          , Ms^Vhha     , Ms          , Ms          , Xu          , Uu          , Uu          , Uu^Vu       , Uu          , Uu          , Uu          , Uu          , Uu          , Uu          , Uu          , Uu          , Uu          , Uu          , Uu          , Cud         , Uu          , Uu          , Uu          , Uu^Vu       , Uu          , Uu          
Ms          , Ms          , Ms          , Ms          , Ms          , Ms          , Ms^Vhha     , Ms          , Ms          , Ms          , Ms          , Ms          , Ms          , Ms          , Ms          , Xu          , Uu          , Uu          , Uu          , Uu          , Uu          , Uu          , Uu^Vu       , Uu          , Uu          , Uu          , Uu          , Uu          , Uu          , Uu          , Uu          , Uu          , Uu          , Uu          , Uu          , Uu          
Ms          , Ms          , Ms          , Ms          , Ms          , Ms          , Ms          , Ms          , Ms          , Ms          , Ms          , Ms          , Ms          , Ms          , Ms          , Xu          , Xu          , Uu          , Uu          , Uu          , Uu          , Uu          , Uu          , Uu          , Uu          , Uu          , Uu          , Uu          , Uu          , Uu^Vu       , Uu          , Uu          , Uu          , Uu          , Uu          , Uu          
Ms          , Ms          , Ms          , Ms          , Ms          , Ms          , Ms          , Ms          , Ms          , Ms          , Ms          , Ms          , Ms          , Ms          , Hh          , Xu          , Uu          , Uu          , Uu          , Uu          , Uu          , Uu          , Uu          , Uu          , Uu          , Uu          , Uu          , Uu          , Uu          , Uu          , Uu          , Uu          , Uu          , Uu          , Uu          , Uu          
